vyyyyyyyyyyyyyn
zo.g........o z
z............ z
z..b .c .i .a.z
z..yyyyyyyyy. z
z............ z
zo..p.......o z
myyyyyyyyyyyyy